           NO      ./textures/stonec.xpm                
           WE                               ./textures/blue.xpm
           F                                255,0,0
           
           SO           ./textures/grey.xpm
           
           
           EA         ./textures/pillar.xpm

C 0,255,100

111111111111111111111111111
100000000011000000000000111
100000000001100010000000011
101100000111000000000000111
100100100000000001000100111
101101010110000000000001111
101100000110100000001011111
101100001110100N00001011111
101100001110100000001000111
101100001110100000001011111
101100001110100000001011111
111111111111111111111111111