		   NO      ./textures/stonec.xpm                
		   WE                               ./textures/blue.xpm
		   F                                255,0,0
		   
		   SO           ./textures/grey.xpm
		   
		   
		   EA   ./textures/pillar.xpm       


C 			0,255,100

1111111111111111111111111111111111                   
1111111111111111111111111111111111111111111111
11111111111111111111111111111   
111111111111111111111111         
111111111111110111111111111         
1111111111111111111111111         
1111111111111111111111111      
111111111111111111111111N1       
11111111111111111111111111








111111111111111111111111
1111111111111111111111111         
111111111111111111111101                                           
1111111111111111111111111111111111
111111111111111111111111111111111
111111111111111111111111111111111
111111111111111111111111111111111
111111111111111111111111111111111    
1111111111111111111111111111111






